1111111111
1000000001
1101110111
1100110011
1111111111
